%%%%%%%
%  P .%
%     %
%     %
%     %
%     %
%%%%%%%
