%%%%%%%
%P    %
%     %
%     %
%     %
%  .  %
%%%%%%%
