%%%%%%%
%P   .%
%     %
%     %
%     %
%     %
%%%%%%%
