%%%%%%%
%P    %
%     %
%     %
%     %
%o . o%
%%%%%%%
