%%%%%%%
%  P o%
%     %
%     %
%     %
%.   o%
%%%%%%%
