%%%%%%%
%P   o%
%     %
%     %
%     %
%.   o%
%%%%%%%
