%%%%%%%
%P    %
%     %
%     %
%     %
%o o .%
%%%%%%%
