%%%%%%%
%P   o%
%     %
%     %
%     %
%o   .%
%%%%%%%
