%%%%%%%
% P   %
% %%% %
% %.  %
% %%%G%
%. GGG%
%%%%%%%
