%%%%%%%
%P    %
%     %
%     %
%     %
%.    %
%%%%%%%
