%%%%%%%
%  P  %
%     %
%     %
%     %
%    .%
%%%%%%%
