%%%%%%%
%   P %
%     %
%     %
%     %
%.   o%
%%%%%%%
