%%%%%%%
%P    %
%     %
%     %
%     %
%  . o%
%%%%%%%
