%%%%%%%
%  P  %
%     %
%     %
%     %
%.   o%
%%%%%%%
