%%%%%%%
% P   %
%     %
%     %
%     %
%.   o%
%%%%%%%
