%%%%%%%
% P   %
%     %
%     %
%     %
%    .%
%%%%%%%
