%%%%%%%
%   P %
%     %
%     %
%     %
%    .%
%%%%%%%
