%%%%%%%%%
%   P   %
%       % 
%       %
%      .%
%%%%%%%%%
