%%%%%%%
%    P%
%     %
%     %
%     %
%  .  %
%%%%%%%
