%%%%%%%
%    P%
%     %
%     %
%     %
%    .%
%%%%%%%
