%%%%%%%
%    P%
%     %
%     %
%     %
%.   o%
%%%%%%%
