%%%%%%%
%    P%
%     %
%     %
%     %
%. o  %
%%%%%%%
