%%%%%%%%%
%   P   %
%       % 
%       %
%.     o%
%%%%%%%%%
