%%%%%%%
%  P  %
%     %
%    o%
%     %
%.    %
%%%%%%%
